9
0 4 4 4 4 4 2 2 2
2 2 2 2 6 2 1 2 2
2 2 2 2 4 2 1 2 2
2 2 2 2 2 2 1 2 2
2 2 2 2 2 2 1 1 1
2 2 2 2 2 6 2 2 2
2 2 2 2 1 1 1 1 2
2 2 2 2 2 2 2 1 2
2 2 2 2 2 2 2 1 7
